I Ran (So Far Away) - A Flock Of Seagulls
Down Under - Men At Work
Take On Me - a-ha
Our House - Madness
Come On Eileen - Dexys Midnight Runners
Mexican Radio - Wall Of Voodoo
You Spin Me Round (Like a Record) - Dead Or Alive
Cars - Gary Numan
Tainted Love - Soft Cell
Oh Yeah - Yello
Whip It - DEVO
Life In A Northern Town - The Dream Academy
Turning Japanese - The Vapors
Blister in the Sun - Violent Femmes
Der Kommissar - Falco
Rock Me Amadeus - The Gold Mix - Falco
I Melt With You (7" Mix) - Modern English
Sweet Dreams (Are Made of This) - Remastered - Eurythmics
Break My Stride - Matthew Wilder
Wake Me up Before You Go-Go - Wham!
Karma Chameleon - Culture Club
People Are People - Depeche Mode
Goody Two Shoes - Adam Ant
I Wanna Be A Cowboy - Boys Don't Cry
Hungry Like The Wolf - Duran Duran
She Blinded Me With Science - Thomas Dolby
Rock This Town - Stray Cats
Stray Cat Strut - Stray Cats
Vacation - The Go-Go's
Venus - Bananarama
Always Something There To Remind Me - Naked Eyes
Every Little Thing She Does Is Magic - The Police
De Do Do Do, De Da Da Da - The Police
Walking On Sunshine - Katrina & The Waves
(I Just) Died in Your Arms - Cutting Crew
Walk Like an Egyptian - The Bangles
Centerfold - The J. Geils Band
Tarzan Boy - Baltimora
Enjoy The Silence - Depeche Mode
867-5309 / Jenny - Tommy Tutone
The Safety Dance - Bonus Track - Men Without Hats
99 Luftballons - Nena
Jessie's Girl - Rick Springfield
Friday I'm In Love - The Cure
You Might Think - The Cars
Overkill - Colin Hay
Call Me - Blondie
Here Comes the Rain Again - Eurythmics
Like A Prayer - Madonna
Who Can It Be Now? - Men At Work
Take My Breath Away - Berlin
I Want Candy - Bow Wow Wow
Working for the Weekend - Loverboy
Relax - Frankie Goes To Hollywood
Every Breath You Take - The Police
Never Gonna Give You Up - Rick Astley
Shout - Tears For Fears
Hold On - Wilson Phillips
Dancing With Myself - Billy Idol
White Wedding - Pt. 1 - Billy Idol
